|                       `._          _'                        |
|                         '"-     ..-'                         |
|                           |     |                            |
|                           |     |                            |
|                           |     |                            |
|                           |     |                            |
|                           |     |                            |
|                           |     |                            |
|                           |     |                            |
|                           |     |                            |
|                           |     |                            |
|                           |     |                            |
|                           |     |                            |
|                           |     |                            |
|                           |     |                            |
|                           |     |                            |
|                           |     |                            |
|                           |     |                            |
|                           |     |                            |
|                           |     |                            |
|                           |     |                            |
|                           |     |                            |
|                           |     |                            |
|                           |     |                            |
|                           |     |                            |
|                           |     |                            |
|                           |     |                            |
|                           |     |                            |
|                           |     |                            |
|                           |     |                            |
|                         ,,'     `._                          |
|                       ./'         '".                        |